LISTES DES LIENS DE FRANCAIS A ANGLAIS :
Armée de Freezer -> Frieza army
Armée du nouveau Freezer -> New Frieza army
Ambition de conquete -> Thirst for conquest
Armée du RR -> RR Army
Auto régénération -> Auto régénération
Absorbeur d'énergie -> Energy absorption
Agrandissement ->Transform
Ame vs ame -> Soul vs Soul 
Amélioration cybernetique -> Organic upgrade
Ami -> Best buddies
Aventure incroyable -> The incredible aventure
Battaille divine -> Super-God Combat
Berserk -> Berserk
Boost de handicap -> Deficit Boost
Boss -> Movie Bosses
Briser la limite -> Shatering The Limite
Cauchemar -> Nightmare
Champion du monde -> World tournement champion
Combat acharné -> Fierce Battle
Combat décisif -> Over in a flash
Combat violent -> Blazing battle
Combatant de l'au-delà -> Othe world warriors
Combo -> Tag team of terror
Commando Ginuy -> The ginuy force
Commando de Cooler -> Coora's armored squad
Conseil des boules de cristal -> Guidance of the Dragon Balls 
Copie -> Attack of the Clones 
Coup puissant -> Bombardment 
Courage -> Courage
Cruauté spacial -> Universe's Most Malevolent 
Cruel -> Brutal Beatdown
Cyborg -> Cyborg
Echec de fusion -> Fusion Failure 
Ecole de la grue -> Crane School 
Ecole tortue -> Turtle school
Energie infinie -> Infinite Energy 
Equipe Bardock -> Team Bardock 
Etoile de l'éspoir -> Budding Warrior 
Destructeur de l'Univers -> Destroyer of the Universe 
Dimension des dieux -> Godly Power 
Disciple -> The Students 
Dodompa -> Dodon Ray 
Dragons maléfique -> Shadow Dragons
Déesse de la guerre -> Battlefield Diva 
Duo de rivaux -> Rival Duo 
Famille Hera -> The Hera Clan
Famille de Son Goku -> All in the Family 
Fierté Saiyan -> Saiyan Pride 
Fonceur -> Infighter 
Forme brisant la limite -> Limit-Breaking Form 
Forme ultime -> Ultimate Lifeform
Formidale ennemi -> Formidable Enemy
Fusion -> Fusion
Futur désespéré -> Dismal Future 
Fuyard -> Flee 
GT-> GT 
Gentleman -> Gentleman
Gourmet ->  Connoisseur
Guerrier Z -> Z Fighters 
Guerrier Z doré -> Golden Z-Fighter
Guerrier de Mamie Voyante -> Fortuneteller Baba's Fighter 
Guerrier doré -> Golden Warrior 
Guerrier fusionné -> Fused Fighter 
Guerrier galactique -> Galactic Warriors
Guerrier suprême -> Supreme Warrior
Guerrier tenace -> Tough as Nails 
Guerrier vétéran -> Experienced Fighters 
Guerrier de l'Univers 6 -> Warriors of Universe 6 
Génie -> Prodigies
Haine des Saiyans -> Hatred of Saiyans
Héros -> Hero 
Héros justicier -> Hero of Justice 
Innocent -> The Innocents 
Intello -> Brainiacs 
Jugement serein -> Cold Judgment 
Jumeaux ->  Twin Terrors 
Kamehameha -> Kamehameha
L'armée de Thalès -> Team Turles
L'étonnant sortilège -> Master of Magic 
La puissance suprême -> Supreme Power
Le puissant peuple -> Strongest Clan in Space 
Le pouvoir d'un dieu -> Power Bestowed by God 
le premier éveillé -> The First Awakened 
Leader maléfique -> Evil Autocrats 
lien inébranlable -> Unbreakable Bond 
Liens familiaux -> Family Ties 
Lignée royale -> Royal Lineage 
Look trompeur -> More Than Meets the Eye 
Loyauté -> Loyalty 
Lâche -> Coward 
L'origine des Saiyans -> The Saiyan Lineage 
Majin -> Majin 
Messager du futur -> Messenger from the Future 
Mur gênant -> The Wall Standing Tall 
Mécanique -> Mechanical Menaces 
Maître-élève -> Master and Pupil 
Namek -> Namekians 
Nouveau -> New
Paré au combat -> Prepared for Battle
Patrouille -> Patrol 
Peur et déséspoir -> Fear and Faith 
Pose du commando -> Signature Pose 
Pouvoir de champion -> Champion's Strength 
Pouvoir démoniaque -> Demonic power
Pouvoir légendaire -> Legendary Power 
Pouvoir écrasant -> Over 9000 
Race Saiyan -> Saiyan Warrior Race 
Rancune renforcée -> Hardened Grudge
Regarde respectueux -> Gaze of Respect
Respect -> Respect 
Riche -> Money Money Money 
Rugissement Saiyan ->
Récupérération -> Revival 
Régénération infinie -> Infinite Regeneration 
Réssurection F -> Resurrection 'F' 
Réssuréction du démon -> Majin Resurrection Plan 
Savant -> Scientist 
Sbire de Cooler -> Coora's Underling
Soldat divin -> Warrior Gods 
Soutien infaillible -> Unfailing support
Style de démon -> Démon style
Style rapide -> Speedy Retribution 
Surbonnée de Freezer -> Frieza's Minion 
Super Saiyan -> Super Saiyan
Super Assaut -> Super Assault
Super compatibilité -> High compatibility
Tournoi du pouvoir -> Tournament of Power 
Transformation -> Metamorphosis
Télékinesie -> Telekinesis 
Télépathie ->  Telepathy
Un nouveau Tenkaichi Budokai ->
Unisson parfait -> Strength in Unity
Village Pingouin -> Penguin Village Adventure 
Visiteur d'ailleur -> Galactic Visitor
Vitesse époustouflante -> Shocking Speed 
Xenoverse -> Xenoverse

LISTE DES CATEGORIE DE FRANCAIS A ANGLAIS :
Absorption de puissance -> Power absorption
Arc enfant -> Db Sage
Aspiration connectées -> Connected Hope
Boss de GT-> GT Bosses
Boss de film -> Movie Bosses
Chaos mondial -> Worldwilde Chaos
Chercheur de boules de cristal ->
Combat rapide -> Accelerated battle
Combatant de l'au delà -> Other world warrirs
Commando Ginyu -> Ginuy Force
Corps et esprit corrompus -> Corroded Body and Mind
Croissance rapide -> Rapid Growth
Crossover -> Crossover
Cyborg -> Android
Cyborg - Saga de Cell -> Androids / Cell Saga
Dernier atout -> Final trump card
Destructeur de planetes -> Planetary destruction
Diabolique et sans merci -> Inhuman deeds
Digne rival -> Worthy Rival
Divin -> Realm of Gods 
Dragon Balle Heroes -> Dragon Ball heroes
Dragon maléfique -> Shadow Dragon Saga 
Enfant -> Youth
Ennemie jurée - Sworn ennemies
Explosion de colère -> Explosion de rage
Famille de Son Goku -> Goku's Family 
Famille de Vegeta -> Vegeta's Family 
Fille pleine de vie -> Peppy Gals 
Force jointes -> Joined Forces
Forme géantes -> Giant form
Fusion -> Fusion
Guerrier inférieur -> Low class warriors
Guerrier de génie -> Gifted warriors
Guerrier galactique -> Space traveling warriors
Héros de GT -> GT Heroes
Héros de la justice -> Defenders of Justice
Héros des films -> Movie heroes
Kamehameha -> Kamehameha
Lien de fraterie -> Sibling's bonds
Lien maitre ett disciple -> Bond of master and disciple
Lien d'amitié -> Bonds of frienship
Lignée diabolique -> Wicked bloodline
Lutte a pleine puissance -> All out Struggle
Légende ancestrale -> Storied Figures 
Namek -> Namek
Objetctif Son Goku -> Target : Goku
Pose Spécial -> Spécial Pose
Potalas -> Potalas
Pouvoir de Majin -> Majin Power
Prodige du combat -> 
Puissance de gorille -> Giant Ape Power
Puissance maximal -> Full Power
Puissance restaurée -> Powerfull comeback
Péripétie celestes -> Heavenly event
Representant de l'univers 7 -> Representatif of Univers 7
Ressucité -> Ressurected Warriors
Saga de Boo -> Boo Saga
Saga de Namek -> Planet Namek Saga
Saga du Futur -> Futur Saga
Saiyan de sang-mélé -> Hybrid Saiyans
Saiyan pur -> Pur Saiyan
Sauveur -> Saviors
Super Saiyan -> Super Saiyan
Super Saiyan 2 -> Super Saiyan 2
Super Saiyan 3 -> Super Saiyan 3
Survie de l'univers -> Universal Survival Saga
Temps limité -> Time limit
Tenkaichi budokai -> Tenkaichi budokai
Terrien -> Earthlings 
Terrifiant conquérants -> Terrifying Conquerror 
Transformation fortifiante -> Transformation boost
Univers 11 -> Univers 11 
Univers 6-> Univers 6 
Vengeance -> Vengeance 
Vie artificielle -> Artificial life forms 
Voyageur du temps -> Time traveler 
Ecole tortue -> Turtle school 
Equipe bardock -> Team Bardock
Eveile miraculeux -> Miraculous Awakening
Evolution maitrisée -> Mastered Evolution
Etre legendaire -> Legendary existence













