Liste des catégorie traduite :
-------------------------->
Absorption de puissance -> Power absorption
Aspiration Connectées -> Connected Hope
Arc enfant -> DB Saga
Boss des film -> Movie Bosses
Boss de GT -> GT Bosses
Combat Rapide -> Accelerated Battle
Chaos mondiale -> Worldwide Chaos
Chercheur de boules de cristal -> Dragon Ball Seekers
Cyborg - Saga de Cell -> Androids/Cell Saga
Cyborg -> Androids
Crossover -> Crossover
Croissance rapide -> Rapid Growth
Corps et esprit corrompus -> Corroded Body and Mind
Combattant de l'au-delà -> Otherworld Warriors
Commando Ginuy -> Ginyu Force
Destructeur de planètes -> Planetary Destruction
Dernier atout -> Final Trumps Card
Digne rival -> Rivals
Dragon Ball Heroes -> Dragon Ball Heroes
Dragon maléfique -> Shadow Dragon Saga
Diabolique et sans merci -> Inhuman Deeds
Divin -> Realms of Gods
Être légendaire -> Legendary Existence
Ennemie Jurée -> Sworn Enemies 
Evolution maitrisée -> Mastered evolution
Explosion de colère -> Exploding rage
Enfant -> Youth
Eveil miraculeux -> Miraculous Awakening
Equipe Bardock -> Team Bardock
Ecole Tortue -> Turtle School
Famille de Vegeta -> Vegeta's Family 
Famille de Son Goku -> Goku's Family
Fille pleine de vie -> Peppy Gals
Force jointes -> Joindes Forces 
Fusion -> Fusion 
Guerrier inférieur -> Low-Class Warriors
Guerriers galactiques -> Space-traveling Warriors
Guerriers de génie -> Gifted Warriors
Héros de la justice -> Defenders of Justice
Héros de GT -> GT Heroes
Héros des Films -> Movie Heroes
Kamehameha -> Kamehameha 
Liens d'amitée -> Bonds of Friendship
Lien de fraterie -> Siblind's Bonds
Lien maître-eleve -> Master-Student Bond
Lutte a plein puissance -> All-out Struggle
Légende Ancetrale -> Storied Figures
Lignée diabolique -> Wicked Bloodline
Namek -> Namekians 
Objectif Son Goku - Target : Goku
Peripetie celestes -> Heavenly Events
Prodige du combat -> Battle of Wits
Pose spécial -> Spécial pose
Puissance restaurée -> Poweful Comeback
Pouvoir de Majin -> Majin Power
Puissance maximal -> Full Power
Potalas -> Potara
Puissance de gorille -> Giant Ape Power
Représentant de l'Univers 7 -> Representatives of Universe 7 
Ressucité -> Resurected Warriors
Survie de l'Univers -> Universe Survival Saga
Saga du futur -> Future Saga
Super Saiyan -> Super Saiyan
Super Saiyan 2 -> Super Saiyan 2
Super Saiyan 3 -> Super Saiyan 3
Sauveur -> Saviors
Saiyan Pur -> Pure Saiyans
Saiyan de sang-mêlé -> Hybrid Saiyans
Saga de Namek -> Planet Namek Saga
Saga de Boo -> Majin Buu Saga
Temps limité -> Time Limit
Transformation fortifiante -> Transformation boost
Terrifiant conquérants -> Terrifying conquerors
Terrien -> Earthlings
Tenkaichi Budokai -> World Tournament 
Univers 11 -> Univers 11
Univers 6 -> Univers 6
Vengeance -> Revenge
Voyageur du temps -> Time travelers
Vie artificielle -> Artificial Life Forms
'Volonté confié'-> Entrusted Will
'Combat fatidique' -> Battle of Fate
'Au-delà du Super Saiyan' -> Beyond Super Saiyan
'Guerrier Fusioné' -> Fused Fighters
----------------------------------------------
Liste des liens traduit :
-------------------------->
Armée de Freezer -> Frieza's Army 
Armée du nouveau Freezer -> New Frieza Army 
Absorbeur d'énergie -> Energy Absorption
Agrandissement -> Transform 
Ame vs ame -> Soul vs Soul 
Amélioration cybernetique -> Organic Upgrade
Ami -> Best Buddies
Aventure incroyable -> The Incredible Adventure
Ambiton de conquêtes -> Thirst for conquest 
Armée du RR -> RR Army
Auto-régénération -> Auto Regeneration 
Briser la limite -> Shatering the Limit
Boss -> Big Bad Bosses
Bataille divine -> Super-God Combat
Berserker -> Berserker
Boost de handicap -> Deficit Boost
Cyborg -> Android Assault
Cauchemar -> Nightmare
Combat acharné -> Fierce Battle
Combat violent -> Blazing Battle
Combatant de l'au-dela -> Otherworld Warriors
Combo -> Tag Team of Terror
Commando de Cooler -> Coora's Armored Squad
Commando Ginyu -> The Ginyu Force
Conseil des boules de cristal -> Guidance of the Dragon Balls
Coup puissant -> Bombardment
Cruauté spatiale -> Universe's Most Malevolent
Cruel -> Brutal Beatdown
Champion du monde -> World Tournement Champion
Combat décisif -> Over in a Flash
Copie -> Attack of clones 
Courage -> Courage
Disciple -> The Students
Destructeur de l'Univers -> Destroyer of the Universe
Déesse de la guerre -> Battlefield Diva
Démon -> Demon 
Dimension des dieux -> Godly Power
Dragons maléfique -> Shadow Dragons 
Duo de rivaux -> Rival Duo
Duo démoniaque -> Demon Duo
Dodompa -> Dodon Ray
Energie infinie -> Infinite Energy
Equipe Bardock -> Team Bardock 
Duo de rivaux -> Rival duo
Echec de fusion -> Fusion Failure
Ecole de la tortue -> Turtle School
Ecole de la grue -> Crane School
Etoile de l'espoir -> Budding Warriors 
Famille de Son Goku -> All in the Family
Famille Hera -> The Hera Clan
Forme ultime -> Ultimate Lifeform
Fusion -> Fusion
Futur désespéré -> Dismal future
Fuyard -> Flee
Fierté Saiyan -> Saiyan Pride
Fonceur -> Infighter
Formidable ennemi -> Formidable ennemy
Fonceur -> Infighter
Forme brisant la limite -> Limit-Breaking Form
Guerrier de tenace -> Tough as Nails
Gentleman -> Gentleman 
GT -> GT
Guerrier de l'Univers 6 -> Warriors of Univers 6
Guerrier de Mamie Voyante -> Fortuneteller Baba's Fighter
Guerrier d'oré -> Golden Warrior
Guerrier fusionné -> Fused Fighter
Guerrier suprême -> Supreme Warriors
Guerrier Z d'oré -> Golden Z-Fighter
Guerrier d'oré -> Golden Warriors
Génie -> Prodigies
Guerrier galactique -> Galactique Warriors
Guerrier vétéran -> Experienced Fighters
Guerrier Z -> Z Fighters
Gourmet -> Connoisseur
Héros -> Hero 
Héros justicier -> Hero of Justice
Haine des Saiyans -> Hatred of Saiyans
Innocent -> The Innocent
Intello -> Brainacs
Jugement serein -> Cold Judgement
Jumeaux -> Twin Terrors
Kamehameha -> Kamehameha
L'étonnant sortilege -> Master of Magic
Le premiere eveillé -> The First Awakening
Look trompeur -> More than Meets the Eye
Le pouvoir d'un dieu -> Power Bestowed by God
L'armée de Thalès -> Team Turles
L'origin des Saiyans -> The Saiyans Lineage
La puissance suprême -> Supreme Power
Lâche -> Coward
Le plus puissant peuple -> Strongest Clan in Space
Leader maléfique -> Evil Autocrats
Liens familiaux -> Family Ties
Liens inébranlable -> Unbreakable Bond
Lignée royale -> Royal Lineage
Loyauté -> Loyatly
Maître-eleve -> Master and Pupil
Mécanique -> Mechanical Menaces
Majin -> Majin
Messager du futur -> Messenger from the Future
Mur gênant -> The Wall Standing Tall
Namek -> Namekians
Nouveau -> New 
Pouvoir légendaire -> Legendary Power
Pouvoir écrasant -> Over 9000
Paré au combat -> Prepared for Battle 
Patrouille -> Patrol
Pouvoir de champion -> Champion's Strenght
Peur et désespoir -> Fear and Faith 
Pose du commando -> Signature Pose
Race Saiyan -> Saiyan Warriors Race
Respect -> Respect
Ressuréction 'F' -> Ressuréction 'F'
Rugissement Saiyan -> Saiyan Roar
Rancune renforcée -> Hardened Grudge
Récupération -> Revival 
Regard respecteux -> Gaze of Respect
Résurrection du démon -> Majin Resurrection
Riche -> Money Money Money
Régéneration infinie -> Infinite Regeneration
Soldat divin -> Warrior Gods
Style rapide -> Speedy Retribution
Surbordonné de Freezer -> Frieza's Minion
Super Saiyan -> Super Saiyan
Savant -> Scientist
Sbire de Cooler -> Coora's Underling
Super Assaut -> Super Strike
Soutien infaillible -> Solid support
Télékinésie -> Telekinesis
Transformation -> Methamorphosis
Tournoi du pouvoir -> Tournament of Power
Télépathie -> Telepathy
Village Pingouin -> Pingouin Village Adventure
Unission Parfaite -> Strenght in Unity 
Un nouveau Tenkaichi Budokai -> World Tournament Reborn
Visiteur d'ailleur -> Galactic Visitor
Vitesse époustouflante -> Shocking Speed
Xenoverse -> Xenoverse

























